XXXXXXXXXX
XX  H XX X
X  XX X  X
X   XX  XX
   XXX X X
XX  XX   X
    X    X
X    XX  X
  X  XX  X
X  X  X  X
XF X  X  X
XXXX XXF X
XXX XX   X  
